############################################################
# *                                                        #
#                                                          #
# *                                   *                    #
#                                                          #
# *                                                        #
#                 #####                                    |
# *               #   #                                    |
#                 #   #                                    |
# *               #####                                    |
#                                                          |
# *                                                        |
#                                                          |
# *                                                        #
#                                                          #
# *                                                        #
#                                                          #
# *                                                        #
#                                                          #
##############-------------#################################
