############################################################
# *                                                        #
#                                                          #
# *                                   *                    #
#                                                          #
# *                                                        #
#                 #####                                     
# *               #   #                                     
#                 #   #                                     
# *               #####                                     
#                                                           
# *                                                         
#                                                           
# *                                                        #
#                                                          #
# *                                                        #
#                                                          #
# *                                                        #
#                                                          #
##############             #################################
