############################################################
#                                                          #
#                                                          #
#                                     *                    #
#                                                          #
#                                                          #
#                 #####                                     
#                 #   #                                     
#                 #   #                                     
#                 #####                                     
#                                                           
#                                                           
#                                                           
#                                                          #
#                                                          #
#                                                          #
#                                                          #
#                                                          #
#                                                          #
##############             #################################
