####------------------- ####################################
#                                                          #
#                                                          #
#                                                          #
#                                                          #
#                                                          |
#                 #####                                    |
#                 #   #                                    |
#                 #   #                                    |
#                 #####                                    |
#                                                          |
#                                                          |
#                                                          |
#      *                                                   |
#                                                          #
#                                                          #
#                                                          #
#                                                          #
#                                                          #
########################-------------------------###########
