################              ##############################
#                                                          #
#                                                          #
#                                     *                    #
#                                                          #
#                                                          #
#                 #####                                    #
                  #   #                                    #
                  #   #                                    #
                  #####                                    #
                                                           #
                                                           #
                                                           #
                               ###                         #
#                                                          #
#                                                          #
#                                                          #
#                                                          #
#                                                          #
############################################################
