####################                             ###########
#                                                          #
#                                                          #
#                                                          #
                                                            
                                                            
                 #####                                      
                 #   #                                      
                 #   #                                      
                 #####                                      
                                                            
                                                            
                                                            
      *                                                     
                                                            
#                                                          #
#                                                          #
#                                                          #
#                                                          #
###############                     ########################
