####                    ####################################
#                                                          #
#                                                          #
#                                                          #
#                                                          #
#                                                           
#                 #####                                     
#                 #   #                                     
#                 #   #                                     
#                 #####                                     
#                                                           
#                                                           
#                                                           
#      *                                                    
#                                                          #
#                                                          #
#                                                          #
#                                                          #
#                                                          #
########################                         ###########
