####################                             ###########
#                                                          #
#                                                          #
#                                  ######                  #
                                                            
                                                            
                 #####                                      
                 #   #                                      
                 #   #               1                      
                 #####                                      
                                                            
                                                            
                                                            
      *                                                     
                                    X                       
#                                                          #
#                                                          #
#                                                          #
#                                                          #
###############                     ########################
