############################################################
#                                                          #
#                                                          #
#                                                          #
#                                                          #
#                                                          #
                 #####                                      
                 #   #                                      
                 #   #                                      
                 #####                                      
                                                            
                                                            
#                                                          #
#      *                                                   #
#                                                          #
#                                                          #
#                                                          #
#                                                          #
#                                                          #
#################                  #########################
