############################################################
#                                                          #
#                                                          #
#                                     *                    #
#                                                          #
#                                                          #
                  #####                                    #
                  #   #                                    #
                  #   #                                    #
                  #####                                    #
                                   #                       #
                                                           #
                                                           #
#                                                          #
#                                                          #
#                                                          #
#                                                          #
#                                                          #
#                                                          #
##############             #################################
