#########                                               ####
#                                                          #
#                                                          #
#                                                          #
#                                                          #
#                                                           
#                 #####                                     
#                 #   #                                     
#                 #   #                                     
#                 #####                                     
#                                                           
#                                                           
#                                                           
#                                                          #
#                                                          #
#                              ##                          #
#                                                          #
#                                                          #
#                                                          #
############################################################
