###########                            #####################
#                                                          #
#                                                          #
#                                                          #
#                                                          #
                                                           #
                  #####                                    #
                  #   #                                    #
                  #   #                                    #
                  #####                                    #
                                                           #
                                                           #
                                                           #
      *                                                    #
#                                                          #
#                                                          #
#                                                          #
#                                                          #
#                                                          #
###################################                  #######
